.......#$#........
.......#.#........
.......###........
..................
........##....X...
........##........
..................
...X..............
..................
..................
..........###.....
..........#.......
..........#.......
..........#.......
..........###.....
.#####............
..................
..................
..................
..................
..............Y...
..................
........##........
...Y....##........
..................
..................
..................
........%.........