.......#$#........
.......#.#........
.......###........
..................
........##....X...
........##........
..................
...X..............
..................
..................
..........###.....
..........#.......
..........#.......
..........#.......
..........###.....
.#####......#.....
............#.....
............#.....
............#.....
............#.....
............#..Y..
............#.....
........##..#.....
...Y....##..#.....
............#.....
............#.....
............#.....
........%...#.....